COOOOOOOOOOCOO
OOOOCOOOOOOOOO
COOOOOOCOOOOOO
OOCOOOCOOCOOOC
OOOOOOOOOOOOOO
OOOOOOOCOOOOOC
OCOOOOCOOOCOCO
OOOOOOOOOOOOOO
